#I######################
#                      #
#             K        #
########## ######      #
#      P               #
##   ###################
#                      #
#                      O
########################